£FFFFFFFFFFFFFFFFFF£
F£FFFFFFF#FFFFFF£FFF
FFFFFFFFFFFFFFFFFFFF
FFFFFFFFFFFF#FFFFFFF
FFF#FFFFFFFFFFFFFFFF
FFFFFFFFFFFFFFFFFFFF
FFFF££FFFFFFFF£££FFF
FF#FFFFFFFFFFFFFFFFF
FFFFFFFFFRFFFFFFFFFF
FFFFFFFFFFFFFFFF£FFF
FFFFFFFFFFFFFFFFFFFF
FFF£FFFFFFFFFFFFFFFF
FFF£FFFFFFFFFFFFFFFF
FFFFFFFFFFFFF##FFFFF
FFFFFFFFFFFFF#FFFFFF
FFFFFFFF£FFFFFFFFFFF
FF£££FFFFFFFFFFFFFFF
FFFFFFFFFFFFF££FFFFF
FF#FFFFFFFFFFFFFFFFF
£FFFFFFF££FFFFFFFFF£